1111111111011
10010000000C1
1000011111001
1P0011E0C0001
1111111111111