1111111111111
1001000B000C1
10CC011111001
1P0011E0C0001
1111111111111